g
gm..g...g...g...ggcg
gg....g...g...g.gg.g
g..gggggggggggg.g..g
g.ggs.dgg....g..g.gg
g..gg.ggg.gg.g.gg..g
gg.g..g...g..g..gg.g
g..g.gg.ggg.ggg.g..g
g.gg..g...g..g..g.gg
g..gg.ggg.gg.g.gg..g
gg.g..g...g..g..gg.g
g..g.gg.ggg.ggg.g..g
g.gg..g...g..g..g.gg
g..gg.ggg.gg.g.gg..g
gg.gg.....gg...mgg.g
g..gggggggggggggg..g
g.ggggggggggggggg.gg
g..g...g...g...g..mg
gg...g...g...g...ggg
g