gggggggggggggggggggg
g.......g...s......g
g......gm.......dggg
g.............gg.ggg
g..................g
g..................g
g..................g
g..................g
g..................g
g..................g
g..................g
g..................g
g..................g
g..................g
g..................g
g..................g
g..................g
gs......c...s.....sg
gggggggggggggggggggg
gggggggggggggggggggg