gggggggggggggggggggg
g.......gm........sg
g......gm........ggg
g........g....gg.ggg
g..................g
g...............gs.g
g..................g
g..................g
g..................g
g..................g
g.................mg
g..................g
g..................g
gs.................g
gs.................g
gs..............gs.g
gs.............g...g
gs......c...sgggdggg
gggggggggggggggggggg
gggggggggggggggggggg