gggggggggggggggggggg
g.......g..........g
g......gm.......dggg
g.............gggggg
g..................g
g..................g
g..................g
g..................g
g..................g
g..................g
g..................g
g..................g
g..................g
g..................g
g..................g
g.......c..........g
g.......c..........g
g.......c..........g
gggggggggggggggggggg
gggggggggggggggggggg